12
0 0 S S S S B S S 0 0 0
0 0 S S S W W S S B B 0
0 0 B 0 B T T T 0 0 0 0
0 0 0 0 0 0 0 0 0 0 W 0
0 0 0 W W T T T 0 0 W 0
0 S 0 0 0 0 0 0 0 0 0 0
0 S 0 0 0 0 0 0 B S B 0
S 0 0 0 0 P 0 0 0 W B 0
S 0 0 0 0 0 0 0 0 B B 0
S 0 W 0 0 0 0 0 0 0 0 0
S 0 0 0 0 S S S 0 0 0 0
S S S S 0 0 0 0 0 0 0 0